22111111111111111111111111111111111111122
21000000000000000000000000000000000000012
10100000000000000000000000000000000000101
10010000000000000000000000000000000001001
10001000000000000000000000000000000010001
10000100000000000000000000000000000100001
10000010000000000000000000000000001000001
10000001000000000000000000000000010000001
10000000100000000000000000000000100000001
10000000010000000000000000000001000000001
10000000001000000000000000000010000000001
10000000000100000000000000000100000000001
10000000000010000000000000001000000000001
10000000000001111111111111110000000000001
10000000000001000000000000010000000000001
10000000000001000000000000010000000000001
10000000000001000000000000010000000000001
10000000000001000000000000010000000000001
10000000000001000000000000010000000000001
10000000000001000000000000010000000000001
10000000000001000004330000010000000000001
10000000000001000000000000010000000000001
10000000000001000000000000010000000000001
10000000000001000000000000010000000000001
10000000000001000000000000010000000000001
10000000000001000000000000010000000000001
10000000000001000000000000010000000000001
10000000000001111111111111110000000000001
10000000000010000000000000001000000000001
10000000000100000000000000000100000000001
10000000001000000000000000000010000000001
10000000010000000000000000000001000000001
10000000100000000000000000000000100000001
10000001000000000000000000000000010000001
10000010000000000000000000000000001000001
10000100000000000000000000000000000100001
10001000000000000000000000000000000010001
10010000000000000000000000000000000001001
10100000000000000000000000000000000000101
21000000000000000000000000000000000000012
22111111111111111111111111111111111111122