211111111111111111112
100000000000000000001
100000000000000000001
100000000000000000001
100000000000000000001
100000000000000000001
211111110000000000001
100000000000000000001
100000000000000000001
100000000000000000001
100000000433000000001
100000000000000000001
100000000000000000001
100000000000011111112
100000000000000000001
100000000000000000001
100000000000000000001
100000000000000000001
100000000000000000001
100000000000000000001
211111111111111111112