2111111111111110111111111111112
1000000000000000000000000000001
1000000000000000000000000000001
1000000000000000000000000000001
1000001111111111111111111000001
1000001000000000000000001000001
1000001000000000000000001000001
1000000000000000000000000000001
1000000000000000000000000000001
1000000000000000000000000000001
1000001000000000000000001000001
1000001000000000000000001000001
1000001111111111111111111000001
1000000000000000000000000000001
1000000000000000000000000000001
1000000000000043300000000000001
1000000000000000000000000000001
1000000000000000000000000000001
1000000000000000000000000000001
1000001111111000001111111000001
1000001000000000000000001000001
1000001000000000000000001000001
1000001000000000000000001000001
1000001000000000000000001000001
1000001000000000000000001000001
1000001111111000001111111000001
1000000000000000000000000000001
1000000000000000000000000000001
1000000000000000000000000000001
1000000000000000000000000000001
2111111111111110111111111111112