2111111111111111111111112
1000000000000000000000001
1000000000000000000000001
1000011111111111111100001
1000010000000000000100001
1000010000000000000100001
1000000000000000000000001
1000000000000000000000001
1000010000000000000100001
1000010000000000000100001
1000011111111111111100001
1000000000000000000000001
1000000000043300000000001
1000000000000000000000001
1000000000000000000000001
1000000000000000000000001
1000011111000001111100001
1000010000000000000100001
1000010000000000000100001
1000010000000000000100001
1000010000000000000100001
1000011111000001111100001
1000000000000000000000001
1000000000000000000000001
2111111111111111111111112