2111111111111111111111111111112
1000000000000000000000000000001
1000000000000000000000000000001
1000000000000000000000000000001
2111111100000000000000011111112
1000000000000000000000000000001
1000000000000000000000000000001
1000000000000001000000000000001
1000000011111112111111100000001
1000000000000001000000000000001
1000000000000001000000000000001
1000000000000001000000000000001
1000000000000000000000000000001
1000000000000000000000000000001
1000000000000000000000000000001
1000000000000043300000000000001
1000000000000000000000000000001
1000000000000000000000000000001
1000000000100000000010000000001
1000000000100000000010000000001
1000000111100000000011100000001
1000000000100000000010000000001
1000000000100000000010000000001
1000000000000000000000000000001
1000000000000000000000000000001
1000000000000000000000000000001
1000000000000000000000000000001
1000000000011111111100000000001
1000000000000001000000000000001
1000000000000001000000000000001
2111111111111112111111111111112