2111111111111111111111111111112
1000000000000000000000000100001
1000000000000000000000000100001
1000011111111111111111111100001
1000010000000000000000000000001
1000010000000000000000000000001
1000010000001000001111111111112
1000010000001000001222222222222
1000010000001000001111111111112
1000010000001000000000000000001
1000010000001000000000000000001
1000010000001000000011111100001
1000010000001000000000000100001
1000010000000000000000000100001
1000010000000000000000000100001
1000010000000043300000000100001
1000010000000000000000000100001
1000010000000000000000000100001
1000010000000000000100000100001
1000011111100000000100000100001
1000000000000000000100000100001
1000000000000000000100000100001
2111111111111000000100000100001
2222222222221000000100000100001
2111111111111000000100000100001
1000000000000000000000000100001
1000000000000000000000000100001
1000011111111111111111111100001
1000010000000000000000000000001
1000010000000000000000000000001
2111121111111111111111111111112