2111111111111112111111111111112
1000000000000001000000000000001
1000000000000001000000000000001
1000001111111112111111111000001
1000001000000001000000001000001
1000001000000001000000001000001
1000001000000001000000001000001
1000001000000001000000001000001
1000001000000000000000001000001
1000001000000001000000001000001
1000001000000001000000001000001
1000001000000001000000001000001
1000001111110001000111111000001
1000000000000000000000000000001
1000000000000000000000000000001
2111111000000043300000001111112
1000000000000000000000000000001
1000000000000000000000000000001
1000001111110001000111111000001
1000001000000001000000001000001
1000001000000001000000001000001
1000001000000001000000001000001
1000001000000000000000001000001
1000001000000001000000001000001
1000001000000001000000001000001
1000001000000001000000001000001
1000001000000001000000001000001
1000001111111112111111111000001
1000000000000001000000000000001
1000000000000001000000000000001
2111111111111112111111111111112