2111111111111112111111111111112
1000000000000001000000000000001
1000000000000001000000000000001
1000000000000001000000000000001
1000000111111111111111110000001
1000000100000000000000010000001
1000000100000000000000010000001
1000000100000000000000010000001
1000000100000000000000010000001
1000000100000000000000010000001
1000000100000000000000010000001
1000000100000000000000010000001
1000000100000000000000010000001
1000000100000000000000010000001
1000000100000000000000010000001
1000000100000043300000010000001
1000000100000000000000010000001
1000000100000000000000010000001
1000000100000000000000010000001
1000000100000000000000010000001
1000000100000000000000010000001
1000000100000000000000010000001
1000000100000000000000010000001
1000000100000000000000010000001
1000000100000000000000010000001
1000000100000000000000010000001
1000000111111111111111110000001
1000000000000001000000000000001
1000000000000001000000000000001
1000000000000001000000000000001
2111111111111112111111111111112