2111111121111111111111121111112
1000000010000000000000010000001
1000000121000001000000121000001
1000000010000012100000010000001
1000100000000001000000000000001
1001210000001000000000000100001
1000100000012100000000001210001
1000000000001000001000000100001
1010000000000000012100000000001
2121000000000100001000000000001
1010000000001210000000000100001
1000000000000100000100001210001
1000000100000000001210000100001
1000001210000000000100000000001
1000000100000000000000010000001
1000000000000043300000121000001
1000000000000001000000010000001
1001000000000012100000000100001
1012100000000001000000001210001
1001000000010000000010000100001
1000000000121000000121000000001
1000000000010000000010000000001
2100000000000000000000000000001
2110000000001000000010000000001
2100000000012100000121000000001
1000001000001000000010000001001
1000012100000001000000000012101
1000001000000012100000000001001
1000000000000001000000000000001
1000000000000000000000000000001
2111111111111111111111111111112