2211111211111112111111121111122
2100000100000001000000010000012
1010000000000001000000121000101
1001000000000112110000010001001
1000101000000001000000000010001
1000012100000001000000000100001
1000001000000000000000001000001
1000000100000000001000010000001
1010000010100000012100100000001
2121000001210000001000000000001
1010000000100000000000000100001
1000000000000000000100001210001
1000000100000000001210000100001
1000001210000000000100000000001
1000000100000000000000000000001
1000000000000043300000000000001
1000000000000001000000000000001
1001000000000012100000000100001
1012100000000001000000001210001
1001000000010000000000000100001
1000000000121000000000000000001
1000000000010000000000000000001
2100000010000000000000100000001
2110000100000000000010010000001
2100001000000000000121001000001
1000011000000001000010000100001
1000112100000001000000000010001
1001001000000112110000000001001
1010000000000001000000000000101
2100000000000001000000000000012
2211111111111112111111111111122