21111111111111111111111111111111111111112
10000000000000000000000000000000000000001
10000000000000000000000000000000000000001
10000000000000000000000000000000000000001
10000000000000000000000000000000000000001
10000000000000000000000000000000000000001
10111111111111111111111111111111111111101
10100000000000000000000000000000000000101
10100000000000000000000000000000000000101
10100000000000000000000000000000000000101
10100011111111111111111111111111111000101
10100010000000000000000000000000001000101
10100010000000000000000000000000001000101
10100010000000000000000000000000001000101
10100010000111111111111111111100001000101
10100010000100000000000000000100001000101
10100010000100000000000000000100001000101
10100010000100000000000000000100001000101
10100010000100011111111111000100001000101
10100010000100000000000001000100001000101
10100010000100000004330001000100001000101
10100010000100000000000001000100001000101
10100010000111111111111111000100001000101
10100010000000000000000000000100001000101
10100010000000000000000000000100001000101
10100010000000000000000000000100001000101
10100011111111111111111111111100001000101
10100000000000000000000000000000001000101
10100000000000000000000000000000001000101
10100000000000000000000000000000001000101
10111111111111111111111111111111111000101
10000000000000000000000000000000000000101
10000000000000000000000000000000000000101
10000000000000000000000000000000000000101
21111111111111111111111111111111111111101
10000000000000000000000000000000000000001
10000000000000000000000000000000000000001
10000000000000000000000000000000000000001
10000000000000000000000000000000000000001
10000000000000000000000000000000000000001
21111111111111111111111111111111111111112