2111111111111111111112111111112
1000000000000000000001000000001
1000000000000000000001000000001
1000000000000000000001000000001
1000000011111100000001000000001
1000000012222100000001000000001
1000000012222100000001000000001
1000000011111100000001000000001
1000000000000000000001000000001
1000000000000000000001000000001
1000000000000000000001000000001
2111111111111111111111000000001
1000000000000000000000000000001
1000000000000000000000000000001
1000000000000000000001111111112
1000000000000043300000000000001
1000000000000000000000000000001
2111111111000000000000000000001
1000000000000000000000000000001
1000000000000000000000000000001
1000000001111111111111111111112
1000000001000000000000000000001
1000000001000000000000000000001
1000000001000000000000000000001
1000000001000000111111000000001
1000000001000000122221000000001
1000000001000000122221000000001
1000000001000000111111000000001
1000000001000000000000000000001
1000000001000000000000000000001
2111111112111111111111111111112