2111111111111111111111111111112
1000000000000000000000000000001
1000000000000000000000000000001
1001000000111111111110000001001
1000100000000000000000000010001
1000010000000000000000000100001
1000001000000000000000001000001
1000000100000000000000010000001
1000000000000000000000000000001
1000000000000000000000000000001
1000000000000000000000000000001
1000000000000000000000000000001
1000000100000000000000010000001
1000000100000000000000010000001
1000000100000000000000010000001
1000000100000043300000010000001
1000000100000000000000010000001
1000000100000000000000010000001
1000000100000000000000010000001
1000000000000000000000000000001
1000000000000000000000000000001
1000000000000000000000000000001
1000000000000000000000000000001
1000000100000000000000010000001
1000001000000000000000001000001
1000010000000000000000000100001
1000100000000000000000000010001
1001000000111111111110000001001
1000000000000000000000000000001
1000000000000000000000000000001
2111111111111111111111111111112