2111111111111111111111111111112
1000000000000000000000000000001
1000000000000000000000000000001
1000000011111111111111100000001
1000000010000000000000100000001
1000000010000000000000100000001
1000000010000000000000100000001
1000000010000000000000100000001
1000000010000000000000100000001
1000000000000000000000000000001
1000000000000000000000000000001
1000000000000000000000000000001
1000011110000000000000111100001
1000010000000000000000000100001
1000010000000000000000000100001
1000010000000043300000000100001
1000010000000000000000000100001
1000010000000000000000000100001
1000011110000000000000111100001
1000000000000000000000000000001
1000000000000000000000000000001
1000000000000000000000000000001
1000000010000000000000100000001
1000000010000000000000100000001
1000000010000000000000100000001
1000000010000000000000100000001
1000000010000000000000100000001
1000000011111111111111100000001
1000000000000000000000000000001
1000000000000000000000000000001
2111111111111111111111111111112