2111111111111111111111112
1000000000000000000000001
1000100000002000000010001
1001210000012100000121001
1000100000001000000010001
1000000000000000000000001
1000000010000000100000001
1000000121000001210000001
1000000010000000100000001
1000100000000000000010001
1001210000000000000121001
1000100000000000000010001
1000000000043300000000001
1000100000000000000010001
1001210000000000000121001
1000100000000000000010001
1000000010000000100000001
1000000121000001210000001
1000000010000000100000001
1000000000000000000000001
1000100000001000000010001
1001210000012100000121001
1000100000001000000010001
1000000000000000000000001
2111111111111111111111112