2111111111111112111111111111112
1000000000000001000000000000001
1000000000000001000000000000001
1000000000000001000000000000001
1000000000000001000000000000001
1000000000000001000000000000001
1000000011111112111111100000001
1000000000000001000000000000001
1000000000000000000000000000001
1000000000000000000000000000001
1000001000000000000000001000001
1000001000000000000000001000001
1000001000000000000000001000001
1000001000000000000000001000001
1000000000000000000000000000001
1000000000000043300000000000001
1000000000000000000000000000001
1000001000000000000000001000001
1000001000000000000000001000001
1000000000000000000000000000001
1000000000000000000000000000001
1000000000000000000000000000001
2111111111100000000011111111112
1000000000100000000010000000001
1000000000100000000010000000001
1000000000100000000010000000001
1000000000100000000010000000001
1000000000000000000000000000001
1000000000000000000000000000001
1000000000000000000000000000001
2111111111111111111111111111112