2111111111112111111111112
1000000000001000000000001
1000000000001000000000001
1000000111112111110000001
1000000000001000000000001
1000000000001000000000001
1000000000000000000000001
1000100000000000000010001
1000100000000000000010001
1000100000000000000010001
1000000000000000000000001
1000000000000000000000001
1000000000043300000000001
1000000000000000000000001
1000100000000000000010001
1000100000000000000010001
1000100000000000000010001
1000000000000000000000001
1000000000000000000000001
2111111100000000011111112
1000000100000000010000001
1000000100000000010000001
1000000000000000000000001
1000000000000000000000001
2111111111111111111111112