222222221111111111112
222222221000000000001
222222221000000000001
222222221000000000001
211111111000000000001
100000000000000000001
100000000000000000001
100000000000000000001
100000000000000000001
100000000000000000001
100000000433000000001
100000000000000000001
100000000000000000001
100000000000000000001
100000000000000000001
100000000000000000001
100000000000111111112
100000000000122222222
100000000000122222222
100000000000122222222
211111111111222222222