21111111111111111111111111112
10000000000000000000000000001
10000000000000000000000000001
10000000000000000000000000001
10011111111111111111111111112
10010000000000000000000000001
10010000000000000000000000001
10010000000000000000000000001
10010001111111111111111111001
10010001000000000000000001001
10010001000000000000000001001
10010001000000000000000001001
10010001000111111111110001001
10010001000000000000010001001
10010001000004330000010001001
10010001000000000000010001001
10010001111111111111110001001
10010000000000000000000001001
10010000000000000000000001001
10010000000000000000000001001
10011111111111111111111111001
10000000000000000000000000001
10000000000000000000000000001
10000000000000000000000000001
10011111111111111111111111112
10000000000000000000000000001
10000000000000000000000000001
10000000000000000000000000001
21111111111111111111111111112