2111111111111111111111112
1000000000000000000000001
1000000000001000000000001
1000000000000000000000001
1000111111110111111110001
1000100000000000000010001
1000100000000000000010001
1000100000000000000010001
1000100000000000000010001
1000100000000000000010001
1000100000000000000010001
1000100000000000000010001
1010000000043300000000101
1000100000000000000010001
1000100000000000000010001
1000100000000000000010001
1000100000000000000010001
1000100000000000000010001
1000100000000000000010001
1000100000000000000010001
1000111111110111111110001
1000000000000000000000001
1000000000001000000000001
1000000000000000000000001
2111111111111111111111112