21111111111111111111111111112
10000000000000000000000000001
10000000000000000000000000001
10100000000001010000000000101
10100000000001010000000000101
10010000000001010000000001001
10001000000001010000000010001
10000100000001010000000100001
10000010000001010000001000001
10000001111111011111110000001
10000001000000000000010000001
10000001000000000000010000001
10000001000000000000010000001
10011111000000000000011111001
10000000000004330000000000001
10011111000000000000011111001
10000001000000000000010000001
10000001000000000000010000001
10000001000000000000010000001
10000001111111011111110000001
10000010000001010000001000001
10000100000001010000000100001
10001000000001010000000010001
10010000000001010000000001001
10100000000001010000000000101
10100000000001010000000000101
10000000000000000000000000001
10000000000000000000000000001
21111111111111111111111111112