2112111111112111111112112
1001000000001000000001001
1001000000001000000001001
1001000000001000000001001
1001000000000000000001001
1001000000000000000001001
1001000000001000000001001
1001000000001000000001001
1001000000001000000001001
1001111110001000111111001
1000000000000000000000001
1000000000000000000000001
2111000000043300000001112
1000000000000000000000001
1000000000000000000000001
1001111110001000111111001
1001000000001000000001001
1001000000001000000001001
1001000000001000000001001
1001000000000000000001001
1001000000000000000001001
1001000000001000000001001
1001000000001000000001001
1001000000001000000001001
2112111111112111111112112