2112111111111111111111112
1001000000000000000000001
1001000000000000000000001
1001000001000001111111112
1001000001000000000000001
1001000001000000000000001
1001000001000000000000001
1001000001000000000000001
1001000001111111111111001
1001000000000000000001001
1001000000000000000001001
1001000000000000000001001
1001000000043300000001001
1001000000000000000001001
1001000000000000000001001
1001000000000000000001001
1001111111111111100001001
1000000000000000100001001
1000000000000000100001001
1000000000000000100001001
1000000000000000100001001
2111111111000000100001001
1000000000000000000001001
1000000000000000000001001
2111111111111111111112112