2111111111111111112111112
1000000000000000001000001
1000000000000000001000001
1000000000000000001000001
1000000000000000001000001
1000000000000000001000001
1000000000000000000000001
2111111111111111101000001
1000000000000000000000001
1000000000000000000000001
1000000000000000000000001
1000000000000000001111112
1000000000043300000000001
1000000000000000000000001
2111111000000000000000001
1000000000000000000000001
1000000000000000000000001
1000000000000000000000001
1000001011111111111111112
1000000000000000000000001
1000001000000000000000001
1000001000000000000000001
1000001000000000000000001
1000001000000000000000001
2111112111111111111111112