211111111121111111112
100000000010000000001
100000000010000000001
100000000010000000001
100000000010000000001
100000000010000000001
100000000010000000001
100000000000000000001
100000000000000000001
100000000000000000001
100000000433000000001
100000000000000000001
100000000000000000001
100000000000000000001
100000000010000000001
100000000010000000001
100000000010000000001
100000000010000000001
100000000010000000001
100000000010000000001
211111111121111111112